.=.=====================...=====
..=.=....................=......
...=...====...=====2===.==.==.==
..===22====........=...=........
..=.=22=...=..=====.===.=====.==
..=.=.....=====..==...==....=..=
...3.....=..=.....====.===.==..=
..=====..=..=..===....=.=....=..
..=......=........====..=.=..5..
..=..=...====22==...=...=.=..=..
..=..=3..=..=..=.===.====.=..=..
=.==...===..=..=..=.....=....=..
=..=...=..=.=.=...==.=.==....===
=55=2=2=..===.=..22....=.=.=====
=55=.=.=..===.=...===.6=.=...===
==.=.===.==.....=.=.===..=.=...=
==.=.===...====..==.....==.=====
==.=..=.2===..=..=.=====.....=..
==.==....=.====...==....===4===.
.===....=..=..===.8===...=....=.
...3=...=..=..=.=.8===..==..===3
.=..3====..=..=.=.8.=====..==...
.=.....=..=.=..===8=..=.=.==..=.
===.=========.====8.=.=.=.==..=.
.====..=.=.=2==.=.8==.=.=.==..=.
==.=.=...=.=......8===========..
=..===..=...==.==.=...====...=..
=...=...=.==..=....====..=.==...
.....====.====..=====....===5...
.=..=..=..=...=.=....=...=..====
.=..=..=..=..===....===..=..==.=
.=.........========.===....=..=.
